1111211221112212112111111121
1..3............44.........2
1.........4.....4..........1
2..............3...........2
1....2.....................2
1...3.....................41
1.3.........3............441
2.........4.............4441
1...3.....44.@............41
1..3............44.........2
1.........4.....4..........1
2..............3...........2
1..3............44.........2
1112111211111112121111111121