111111111111111111111111
1..3............44.....1
1.........4.....4......1
1..............3.......1
1....1.................1
1...3..................1
1.3.........3..........1
1.........4............1
1...3.....44.@.........1
1..3............44.....1
1.........4.....4......1
1..............3.......1
1..3............44.....1
1.......3........4.....1
111111111111111111111111